"filename", "language", "JavaScript", "HTML", "CSS", "comment", "blank", "total"
"/Users/philippmeyer/Documents/VSCodeProjects/dieVision/docs/assets/css/picture.css", "CSS", 0, 0, 134, 0, 27, 161
"/Users/philippmeyer/Documents/VSCodeProjects/dieVision/docs/assets/css/starting-page.css", "CSS", 0, 0, 62, 0, 10, 72
"/Users/philippmeyer/Documents/VSCodeProjects/dieVision/docs/assets/js/rotation.js", "JavaScript", 230, 0, 0, 24, 54, 308
"/Users/philippmeyer/Documents/VSCodeProjects/dieVision/docs/atacama-desert.html", "HTML", 0, 63, 0, 1, 13, 77
"/Users/philippmeyer/Documents/VSCodeProjects/dieVision/docs/bad-wildbad.html", "HTML", 0, 51, 0, 1, 12, 64
"/Users/philippmeyer/Documents/VSCodeProjects/dieVision/docs/cerro-paranal.html", "HTML", 0, 55, 0, 1, 13, 69
"/Users/philippmeyer/Documents/VSCodeProjects/dieVision/docs/index.html", "HTML", 0, 60, 0, 1, 11, 72
"/Users/philippmeyer/Documents/VSCodeProjects/dieVision/docs/skyline.html", "HTML", 0, 57, 0, 1, 12, 70
"/Users/philippmeyer/Documents/VSCodeProjects/dieVision/docs/space.html", "HTML", 0, 41, 0, 0, 10, 51
"/Users/philippmeyer/Documents/VSCodeProjects/dieVision/docs/vancouver.html", "HTML", 0, 61, 0, 1, 14, 76
"Total", "-", 230, 388, 196, 30, 176, 1020