"filename", "language", "CSS", "HTML", "JavaScript", "comment", "blank", "total"
"/Users/philippmeyer/Documents/VSCodeProjects/dieVision/docs/assets/css/picture.css", "CSS", 134, 0, 0, 0, 27, 161
"/Users/philippmeyer/Documents/VSCodeProjects/dieVision/docs/assets/css/starting-page.css", "CSS", 62, 0, 0, 0, 10, 72
"/Users/philippmeyer/Documents/VSCodeProjects/dieVision/docs/assets/js/rotation.js", "JavaScript", 0, 0, 221, 24, 50, 295
"/Users/philippmeyer/Documents/VSCodeProjects/dieVision/docs/atacama-desert.html", "HTML", 0, 54, 0, 1, 12, 67
"/Users/philippmeyer/Documents/VSCodeProjects/dieVision/docs/bad-wildbad.html", "HTML", 0, 51, 0, 1, 12, 64
"/Users/philippmeyer/Documents/VSCodeProjects/dieVision/docs/cerro-paranal.html", "HTML", 0, 55, 0, 1, 13, 69
"/Users/philippmeyer/Documents/VSCodeProjects/dieVision/docs/index.html", "HTML", 0, 62, 0, 1, 12, 75
"/Users/philippmeyer/Documents/VSCodeProjects/dieVision/docs/skyline.html", "HTML", 0, 51, 0, 1, 13, 65
"/Users/philippmeyer/Documents/VSCodeProjects/dieVision/docs/space.html", "HTML", 0, 32, 0, 0, 9, 41
"/Users/philippmeyer/Documents/VSCodeProjects/dieVision/docs/vancouver.html", "HTML", 0, 52, 0, 1, 12, 65
"Total", "-", 196, 357, 221, 30, 170, 974